20
12
XXXXXXXXXXXXXXXXXXXX
X X              X X
X XXX XXX XXXXXX X X
X     X X          X
XXXXX XXX XXXXX XX X
X         X   X XX X
X XXX XXX XXXXX    X
X XXX            X X
X X X  X XXXXXXX X X
X X X XX    X    X X
X   X  XXXX   XX   X
XXXXXXXXXXXXXXXXXXXX