12
20
XXXXXXXXXXXXXXXXXXXX
X X   dddDddd    X X
X XXX XXX XXXXXX X X
X     X X dddDdd   X
XXXXX XXX XXXXX XX X
X         X   X XX X
X XXX XXX XXXXX    X
X XXXd    ddddd  X X
X X Xd X XXXXXXX X X
X X XdXXXXXXX    X X
X     XXX   < XX   X
XXXXXXXXXXXXXXXXXXXX
