12
20
XXXXXXXXXXXXXXXXXXXX
X X   dddDddd    X X
X XXX XXX XXXXXX X X
X     X X dddDdd   X
XXXXX XXX XXXXX XX X
X         X   X XX X
X XXX XXX XXXXX    X
X XXX     ddddd  X X
X X X  X XXXXXXX X X
X X X XX    X    X X
X           < XX   X
XXXXXXXXXXXXXXXXXXXX