23
25
XXXXXXXXXXXXXXXXXXXXXXXXX
XdddddddddddXdddddddddddX
XdXXXXdXXXXdXdXXXXdXXXXdX
XdX  XdX  XdXdX  XdX  XdX
XdXXXXdXXXXdXdXXXXdXXXXdX
XdddddddddddddddddddddddX
XdXXXXdXdXXXXXXXdXdXXXXdX
XddddddXddddXddddXddddddX
XXXXXXdX         XdXXXXXX
     XdX XXX-XXX XdX     
XXXXXXdX X     X XdXXXXXX
X        X     X        X
XXXXXXdX XXXXXXX XdXXXXXX
     XdX         XdX     
XXXXXXdX XXXXXXX XdXXXXXX
XdddddddddddXdddddddddddX
XdXXXXdXXXXdXdXXXXdXXXXdX
XddddXddddd < dddddXddddX
XXXXdXdXdXXXXXXXdXdXdXXXX
XddddddXddddXddddXddddddX
XdXXXXXXXXXdXdXXXXXXXXXdX
XdddddddddddddddddddddddX
XXXXXXXXXXXXXXXXXXXXXXXXX