23
25
XXXXXXXXXXXXXXXXXXXXXXXXX
XdddddddddddXdddddddddddX
XdXXXXdXXXXdXdXXXXdXXXXdX
XDX  XdX  XdXdX  XdX  XDX
XdXXXXdXXXXdXdXXXXdXXXXdX
XdddddddddddddddddddddddX
XdXXXXdXdXXXXXXXdXdXXXXdX
XddddddXddddXddddXddddddX
XXXXXXdX         XdXXXXXX
     XdX XXX-XXX XdX     
XXXXXXdX X     X XdXXXXXX
X        X     X        X
XXXXXXdX XXXXXXX XdXXXXXX
     XdX         XdX     
XXXXXXdX XXXXXXX XdXXXXXX
XdddddddddddXdddddddddddX
XdXXXXdXXXXdXdXXXXdXXXXdX
XDdddXddddd < dddddXdddDX
XXXXdXdXdXXXXXXXdXdXdXXXX
XddddddXddddXddddXddddddX
XdXXXXXXXXXdXdXXXXXXXXXdX
XdddddddddddddddddddddddX
XXXXXXXXXXXXXXXXXXXXXXXXX