23
25
XXXXXXXXXXXXXXXXXXXXXXXXX
XdddddddddddXdddddddddddX
X XXXXdXXXX X XXXX XXXX X
X X  XdX  X X X  X X  X X
X XXXXdXXXX X XXXX XXXX X
X     d                 X
X XXXXdX XXXXXXX X XXXX X
X dddddX    X    X      X
XXXXXXdX         X XXXXXX
     XdX XXX XXX X X     
XXXXXXdX X     X X XXXXXX
X     d  X     X        X
XXXXXXdX XXXXXXX X XXXXXX
     XdX         X X     
XXXXXXdX XXXXXXX X XXXXXX
X     d     X           X
X XXXXdXXXX X XXXX XXXX X
X    Xddddd < dddddX    X
XXXX X X XXXXXXX X X XXXX
X      X    X    X      X
X XXXXXXXXX X XXXXXXXXX X
X                       X
XXXXXXXXXXXXXXXXXXXXXXXXX