31
28
XXXXXXXXXXXXXXXXXXXXXXXXXXXX
X            XX            X
X XXXX XXXXX XX XXXXX XXXX X
X X  X X   X XX X   X X  X X
X XXXX XXXXX XX XXXXX XXXX X
X                          X
X XXXX XX XXXXXXXX XX XXXX X
X XXXX XX XXXXXXXX XX XXXX X
X      XX    XX    XX      X
XXXXXX XXXXX XX XXXXX XXXXXX
     X XXXXX    XXXXX X     
     X XX          XX X     
     X XX XXX  XXX XX X     
XXXXXX XX X      X XX XXXXXX
X         X      X         X
XXXXXX XX X      X XX XXXXXX
     X XX XXXXXXXX XX X     
     X XX          XX X     
     X XX XXXXXXXX XX X     
XXXXXX XX XXXXXXXX XX XXXXXX
X            XX            X
X XXXX XXXXX XX XXXXX XXXX X
X XXXX XXXXX XX XXXXX XXXX X
X   XX        <       XX   X
XXX XX XX XXXXXXXX XX XX XXX
XXX XX XX XXXXXXXX XX XX XXX
X      XX    XX    XX      X
X XXXXXXXXXX XX XXXXXXXXXX X
X XXXXXXXXXX XX XXXXXXXXXX X
X                          X
XXXXXXXXXXXXXXXXXXXXXXXXXXXX